################################################################################
#####################  ##         ##  ##########################################
#########     #######  ##         ##  ###############      #######         #####
#####          ######  ##         ##  #############          ######        #####
####            #####  ##         ##  ##########                ###       ######
####                P  ##         ##  ##########                        ########
####            #####  ##         D   ##########                       #########
##########P##########  ##         ##  ##########                    ############
#######      ########   D         ##  #############             ################
########        #####  ##         ##  #################      ###################
#######        ######  ##         ##  ##################P#######################
#####             ###  #############   C                   C                   #
######          ##### C#############      C                                    #
#######       #######  #############  #############  #############  #####P######
#####################  #############  #############  #############  #      C  ##
#####################  #############  #######    ##  #############  #         ##
#  C                                  ##         ##  #############C #         ##
#                                     ####      ###  #############  #         ##
#############  ##################### C####     ####  #############  #         ##
#############  #####################  ######    ###  #############  ############
#############  #####################  ####      ###  #############  ############
#############  ###         #########  #         ###  ##         ##  ############
###         #  ###C        #########  #C        D     D         ##  ############
###         #    D         #########  D         ###  ##         ##  ############
###         P  ###         D          ####      ###  ##         D   ############
###         #  ###         #########  ######    ###  ##         ##  ############
###   C     #C #####################  #############  #############  ############
#############  #####################  ############# C#############  ############
#############C #####################  #############  #############  ############
#############  #####################  #############  #############  ############
################################################################################