################################################################################
###########################  ################  ###############  ################
###########################  ################  ###############  ################
###########################  ################  ###############  ################
###########################  ################  ###############  ################
###########################  ################  #         #####  ##         #####
####   C       C  ######### C################  D         D      ##         #####
####              #########  #    C     #####  #         #####   D         #####
####             C#########  D          D      #         #####  ##         #####
####              #########  #          #####  #         #####  ##         #####
####              D          #          #####  #         #####  ################
####              #########  #       C  #####  ###############  ################
####              #########  ################  ###############                 #
####              #########  ################  ###############           C     #
####C             #########                                     ################
####              #########                                     ################
###########################  #############  ##################  ################
#                            #############  ##################  ################
#                            #############  ##################  ################
#############  ############  #############  ##################  #####         ##
#############  ############  #############  ########         #C     D         ##
###         #  #     C   ##  #      C  ###  ########         #  #####         ##
###         P  #         ##  P         ###  ########         #  #####         ##
###         #  #         D   #         ###  ########         #  #####  C      ##
###         #  D         ##  #           P  ########         D  ################
###         #  #         ##  #      C  ###  ########         #  ################
###         #  ############  #############         D         #  ################
#############C ############  #############  ########         #  ################
#############  ############  #############C ##################  ################
#############  ############  #############  ##################  ################
################################################################################