################
#     #  #     #
#     #  #     #
#     #  #     #
#######  #######
#     #  #     #
#     #  #     #
#     #  #     #
################
#              #
#              #
################