################
#     #  #     #
#     D  D     #
#     #  # C   #
#######  #######
#     #  #     #
#     D  D     #
#     #  #     #
###D#######D####
#              #
#         C    #
################