########################################
#######  ###########  #########  #######
#######  ###    ####  ####    #  ##    #
#######    D    D        D    D   D    #
## C  #  ###    ####  ####    #  ##  C #
##    #  ###########  #########  #######
##    #                                #
##    #                                #
##    #  ###########  #########  #######
##    #  ####    ###  #########  #######
##    P     D    D    ### C  ##  #######
##    #  ####    ###    D    D   #  C ##
##    #  ###########  ###    ##  #    ##
##    #  ###########  #########  #    ##
##C   #      C                   #    ##
##    #                          P    ##
##    #  ###########  #########  #    ##
##    #  ####  C ###  #    ####  #######
#######     D    D    D    D     #######
#######  ####    ###  #    ####  #######
########################################