####################
##    #  ###########
##    D  ##  C   ###
##    #   D      ###
#######  ##      ###
#######  ###########
#                  #
#  C               #
#######  ###########
#######  #    ######
##C   #  D    ######
##    #  #    ######
##    P  ###########
##    #  ###########
####################