########################################
#    ##  ######  #######################
#    D   #    #  #######          C   ##
#    ##  P    P        D              ##
#######  #    #  #######              ##
#######  ######  #######################
#                         C            #
#                                      #
#######  ###############################
#    ##  #####         #################
#     P      D         #################
#  C ##  #####         #################
#######  ###############################
#           C               C          #
#                     C                #
#######  ########  ########  ###########
#######  ##    ##  ###    #  ###########
##    #   D    D     D    D  ###    ####
##    D  ##    ##  ###    #    D    ####
##    #  ########  ########  ###   C####
########################################