####################
#######  ###########
#    ##  #    ######
#    D   D    ######
#    ##  #    ######
#######  ###########
#          C       #
#                  #
###########  #######
########### C#    ##
###########  P    ##
####    ###  #  C ##
####    D    #######
####    ###  #######
####################